#####################################
#A      #                           #
# ##### # ######################### #
# #   # # #                       # #
# # # # # # ##################### # #
# # #   # # #                   # # #
# ####### # # ################# # # #
#         # # #               # # # #
########### # # ############# # # # #
#           # # #     B       # # # #
# ########### # ############### # # #
# #           #                   # #
# ################################# #
#                                   #
#####################################